1111111111
1111000111
1111110111
1111110111
1111110011
1101111111
1111011111
1111011111
1111011111
1111111111
