1111111111
1111000111
1111110111
1111110111
1110000011
1101111111
1110011111
1111011111
1000000001
1111111111
